111111111111111111111110001111111111111111111111111
100000000000000010000010001000000000000100000000001
100000000000000000000010001000000000000000000000001
100000000000000000000010001000000000000000000000001
100000000000000010000010001000000000000100000000001
100000000000000011111111111000000000000100000000001
100000000000000000000010000000000000000111111111111
1000000000000000000000200000000000000001
1000000000000000000000200000000000000001
1111111111111111111111111111111111111111







11111111111111111111111111111111111111111
10000000000100001000000000000000000000001
10000000000100001000000000000000000000001
10000000000110011000000000000000000000001
10000000000000000000000000000000000000000
10000000000000000000000000011100110000000
10000000000000000000000000010000010000001
10000000000000000000000000010000010000001
11111111111111111111111111111111111111111